빨강 양귀비(Papaver) : 위로
수레국화(Corn Flower) : 행복
수박풀(Flower of an Hour) : 아가씨의 아름다운 자태
옥수수(Corn) : 재보(財寶)
엘리카(Heath) : 고독
능소화(Trumpet Flower) : 명예
석류(Pomagranate) : 원숙한 아름다움
진달래(Azalea) : 사랑의 희열
시스터스(Cistus) : 인기
이끼(Moss) : 모성애
빨강무늬제라늄(Geranium Zonal) : 위안
협죽도(Oleander) : 위험
골든 로드(Golden Rod) : 경계
저먼더(Wall Germander) : 경애
해바라기(Sun Flower) : 광휘
타마린드(Tamarindus) : 사치
튤립나무(Tulip-Tree) : 전원의 행복
접시꽃(Holly Hock) : 열렬한 사랑
로사 캠피온(Rosa Campion) : 성실
프리지아(Freesia) : 순결
짚신나물(Agrimony) : 감사
스피리아(Sprirea) : 노력
서양종 보리수(Lime Tree, Linden) : 부부애
금잔화(Calendula) : 이별의 슬픔
안스륨(Flaming Flower) : 사랑에 번민하는 마음
하이포시스 오리어(Hypoxis Aurea) : 빛을 찾다
고비(Osumunda) : 몽상
에린지움(Eryngium) : 비밀스런 애정
꽃담배(Flowering Tabacco Plant) : 그대 있어 외롭지 않네
저먼더(Wall Germander) : 담백
토끼풀(Clover) : 약속